o11111oy11111yr11111ry11111yp10001pp11111pb11111bp11111pb11111b
100000110000011000001100000110000011000001100000110000011000001
100k00110000000000001100000110000011000000000000110000000000001
100000110000000000001100000110000011000000000000110000000000001
100000110000000000001100m0011000001100000000000011000000000i001
100000110000000000001100000110000011000000000000110000000000001
100m00110000000000001100000110000011000000000000110000000000001
100000110000011000001100000110000011000001100000110000011000001
o11111oy10001yr10001ry1www1yp10001pp10001pb10001bp10001pb11111b
y11111yg10001gb10001bg10001gb10001br10001rg10001gr10001ro11111o
100000110000011000001100000110000011000001100000110000011000001
100000110000000000001100000000000011000001100j00110000000000001
100000110000000000001100000000000011000001100000110000000000001
100u0011000000000j00110000000000001100k001100000110000000000001
100000110000000000001100000000000011000001100000110000000000001
100000110000000000001100000000000011000001100u00110000000000001
100000110000011000001100000110000011000001100000110000011000001
y10001yg11111gb11111bg11111gb11111br11111rg10001gr11111ro10001o
o10001oy11111yg11111gr11111ro11111oy11111yp10001pr11111ro1www1o
100000110000011000001100000110000011000001100000110000011000001
100000w0000000000000110000011000000w000001100000000000000000001
100000w00000000000001100n0011000000w000001100000000000000000001
100000w0000000000i0011000001100n000w000001100000000000000000001
100000w0000000000000110000011000000w000001100000000000000000001
100000w0000000000000110000011000000w000001100000000000000000001
100000110000011000001100000110000011000001100000110000011000001
o10001oy11111yg11111gr10001ro11111oy10001yp10001pr11111ro11111o
r10001ro11111ob11111bp10001pq11111qo10001or10001rq11111qq11111q
100000100000011000001100000110000011000001100000110000011000001
100000000000011000000000000111000111000000000000110000000000001
100000000000011000000000000110101011000000000000110000000000001
100000000000011000000000000110060011000000000000110000000000001
100000000000011000000000000110101011000000000000110000000000001
100000000000011000000000000111000111000000000000110000000000001
100000110000011000001100000110000011000001100000110000011000001
r10001ro10001ob10001bp11111pq10001qo11111or11111rq10001qq10001q
11q00q1y10001yg1www1gq11111qq10001qq11111qq11111qq10001q1000001
1q00q111000001100000110000011000001100000110000011000001q10q01q
110q011100000000000011000001q10001q100000110000000000001q10q01q
11q00q1100000000000011010101q1xxx1q101010110000000000001q10q01q
1q00q11100000000000011000001100000110000011007000000000110qqq01
110q011100000000000011001001q1zzz1q101010110000000000001q10q01q
11q00q1100000000000011010101q10001q100100110000000000001q10q01q
1q00q111000001100000110000011000001100000110000011000001q10q01q
1100011y11111yg11111gq10001qq10001qq10001qq11111qq11111q1000001
q10001qq1q1q1qq1q1qqqx10001xq10001qz10001zq11111qq11111qq10001q
1000001101010110101qq100000110000011000001100000110000011000001
q1000000000000000001q10000000x000z00000001100000000000000000001
10000000000000000000110000000x000z00000001100000000000000000001
q1000000000000000001q1000000x00000z0000001100000000000000000001
10000000000000000000110000000x000z00000001100000000000000000001
q1000000000000000001q10000000x000z00000001100000000000000000001
100000110000011000001100000110000011000001100000110000011000001
q1sss1qq10001qq10001qx11111xz10001qz11111zq10001qq10001qq11111q
q10001qq10001qq10001qq1q1qqqq10001qq11111qq10001qq10001qq11111q
10000011000001100000110101qq10000011000001100000110000011000001
000001qq10001qq100000000001qq10001q1000000000000110000011000000
000000110000011000000000000110000011000000000000110000011000000
000001qq10001qq100000000001qq10001q1000000000000110000011000000
000000110000011000000000000110000011000000000000110000011000000
000001zz10001zz100000000001zz10001x1000000000000110000011000000
10101011000001zz1010110101zz10000011000001100000110000011000001
z1zz11zz10001zzzz1z1zz1zzzzzz10001xx11111xx11111xx10001xx10001x
zzz1z1zz10001zzzz1z1zz1z1zzzz10001xxx1111xxxxxxxxx10001xx1aaa1x
zz101011000001zz1010110101zzz10001xx10000111xxxxxx10001xx10001x
z100000000001zz100000000001110000011000000001xxxxx10001xx10001x
100000000000011000000000000000000000000000001111110000011000001
z100000000001zz100000000000000000000000000000000000000000000001
100000000000011000000000000000000000000000001111110000011000001
z100000000001zz100000000001110000011000000001xxxxx10001xx10001x
10000011000001100000110101zzz10001xx10000111xxxxxx10001xx10001x
z10001zz10001zz10001zz1z1zzzz10001xxx1111xxxxxxxxx10001xx10001x
z10001zz10001zz10001zz1z1zzzz10001xx111111111111xx10001xx10001x
10000011000001100000110101zzz10001x1000000000000110000011000001
z10001zz1000000000000000001zz10001x10111111000000000000110s0001
1a0a0a1100000000000000000001z10001x100000110000000000001100s0s1
z1a0a1zz10000000000000004001z10001x11111011000000000000110s3s01
1a020a1100000000000000000001z10001x1000001100000000000011s0s001
z1a0a1zz1000000000000000001zz10001x1011111100000000000011000s01
zz1a1zzzz10101101010110101zzz10001x1000051100000110000011000001
zzz1zzzzzz1z1zz1z1z1zz1z1zzzz10001xx11111xx11111xx11111xx11111x